25 20
##d########   #####d#####
#.@.......#   #....g....#
#.........#   #.........#
#.........#   #.........#
#.........#   #.........#
#.........#   #....p....#
#..t...t..#   #.........#
####...####   ####...####
   #...#         #...#
   #...#  #####  #...#
   #...#  #.t.#  #...#
   #...#  #tkt#  #...#
   #...#  #...#  #...#
   #...#  ##.##  #...#
   #...#   #.#   #...#
   #...#####.#####...#
   #....s..s.s.......#
   #.....s........s..#
   #....s......s.....#
   ###################
