25 20
###########   #####d#####
#.d@......#   #.........#
#.........#   #.........#
#.........#   #.........#
#........t#   #.........#
#.........#   #.........#
#.........#   #.........#
####...####   ####...####
   #...#         #...#
   #...#  #####  #...#
   #...#  #.t.#  #...#
   #...#  #tkt#  #...#
   #...#  #...#  #...#
   #...#  ##.##  #...#
   #...#   #.#   #...#
   #...#####.#####...#
   #....s..s.s.......#
   #.....s........s..#
   #....s......s.....#
   ###################
