25 20
###########   #####d#####
#.d@......#   #.........#
#.........#   #.........#
#.........#   #.........#
#.........#   #.........#
#.........#   #.........#
#.........#   #.........#
####...####   ####...####
   #...#         #...#
   #...#  #####  #...#
   #...#  #...#  #...#
   #...#  #.k.#  #...#
   #...#  #...#  #...#
   #...#  ##.##  #...#
   #...#   #.#   #...#
   #...#####.#####...#
   #....s..s.s.......#
   #.....s........s..#
   #....s......s.....#
   ###################
